異	い	こと, こと.なる, け	Uncommon, Different, Queerness, Strangeness, Wonderful, Curious, Unusual
遺	い, ゆい	のこ.す	Bequeath, Leave Behind, Reserve
域	いき		Range, Region, Limits, Stage, Level
宇	う		Eaves, Roof, House, Heaven
映	えい	うつ.る, うつ.す, は.える, -ば.え	Reflect, Reflection, Projection
延	えん	の.びる, の.べる, の.べ, の.ばす	Prolong, Stretching
沿	えん	そ.う, -ぞ.い	Run Alongside, Follow Along, Run Along, Lie Along
我	が	われ, わ, わ.が-, わが-	Ego, I, Selfish, Our, Oneself
灰	かい	はい	Ashes, Puckery Juice, Cremate
拡	かく, こう	ひろ.がる, ひろ.げる, ひろ.める	Broaden, Extend, Expand, Enlarge
革	かく	かわ	Leather, Skin, Reform, Become Serious
閣	かく		Tower, Tall Building, Palace
割	かつ	わ.る, わり, わ.り, わ.れる, さ.く	Proportion, Comparatively, Divide, Cut, Separate, Split
株	しゅ	かぶ	Stocks, Stump, Shares, Stock, Counter For Small Plants
干	かん	ほ.す, ほ.し-, -ぼ.し, ひ.る	Dry, Parch, Ebb, Recede, Interfere, Intercede
巻	かん, けん	ま.く, まき, ま.き	Scroll, Volume, Book, Part, Roll Up, Wind Up, Tie, Coil, Counter For Texts (or Book Scrolls)
看	かん	み.る	Watch Over, See
簡	かん, けん	えら.ぶ, ふだ	Simplicity, Brevity
危	き	あぶ.ない, あや.うい, あや.ぶむ	Dangerous, Fear, Uneasy
机	き	つくえ	Desk, Table
揮	き	ふる.う	Brandish, Wave, Wag, Swing, Shake
貴	き	たっと.い, とうと.い, たっと.ぶ, とうと.ぶ	Precious, Value, Prize, Esteem, Honor
疑	ぎ	うたが.う	Doubt, Distrust, Be Suspicious, Question
吸	きゅう	す.う	Suck, Imbibe, Inhale, Sip
供	きょう, く, くう, ぐ	そな.える, とも, -ども	Submit, Offer, Present, Serve (meal), Accompany
胸	きょう	むね, むな-	Bosom, Breast, Chest, Heart, Feelings
郷	きょう, ごう	さと	Home Town, Village, Native Place, District
勤	きん, ごん	つと.める, -づと.め, つと.まる, いそ.しむ	Diligence, Become Employed, Serve
筋	きん	すじ	Muscle, Sinew, Tendon, Fiber, Plot, Plan, Descent
系	けい		Lineage, System
敬	けい, きょう	うやま.う	Awe, Respect, Honor, Revere
警	けい	いまし.める	Admonish, Commandment
劇	げき		Drama, Play
激	げき	はげ.しい	Violent, Get Excited, Enraged, Chafe, Incite
穴	けつ	あな	Hole, Aperture, Slit, Cave, Den
絹	けん	きぬ	Silk
権	けん, ごん	おもり, かり, はか.る	Authority, Power, Rights
憲	けん		Constitution, Law
源	げん	みなもと	Source, Origin
厳	げん, ごん	おごそ.か, きび.しい, いか.めしい, いつくし	Stern, Strictness, Severity, Rigidity
己	こ, き	おのれ, つちのと, な	Self
呼	こ	よ.ぶ	Call, Call Out To, Invite
誤	ご	あやま.る, -あやま.る	Mistake, Err, Do Wrong, Mislead
后	こう, ご	きさき	Empress, Queen, After, Behind, Back, Later
孝	こう, きょう		Filial Piety, Child's Respect
皇	こう, おう		Emperor
紅	こう, く	べに, くれない, あか.い	Crimson, Deep Red
降	こう, ご	お.りる, お.ろす, ふ.る, ふ.り, くだ.る, くだ.す	Descend, Precipitate, Fall, Surrender
鋼	こう	はがね	Steel
刻	こく	きざ.む, きざ.み	Engrave, Cut Fine, Chop, Hash, Mince, Time, Carving
穀	こく		Cereals, Grain
骨	こつ	ほね	Skeleton, Bone, Remains, Frame
困	こん	こま.る	Quandary, Become Distressed, Annoyed
砂	さ, しゃ	すな	Sand
座	ざ	すわ.る	Squat, Seat, Cushion, Gathering, Sit
済	さい, せい	す.む, -ず.み, -ずみ, す.まない, す.ます, -す.ます, すく.う, な.す, わたし, わた.る	Settle (debt, Etc.), Relieve (burden), Finish, Come To An End, Excusable, Need Not
裁	さい	た.つ, さば.く	Tailor, Judge, Decision, Cut Out (pattern)
策	さく		Scheme, Plan, Policy, Step, Means
冊	さつ, さく	ふみ	Tome, Counter For Books, Volume
蚕	さん, てん	かいこ, こ	Silkworm
至	し	いた.る	Climax, Arrive, Proceed, Reach, Attain, Result In
私	し	わたくし, わたし	Private, I, Me
姿	し	すがた	Figure, Form, Shape
視	し	み.る	Inspection, Regard As, See, Look At
詞	し	ことば	Part Of Speech, Words, Poetry
誌	し		Document, Records
磁	じ		Magnet, Porcelain
射	しゃ	い.る, さ.す, う.つ	Shoot, Shine Into, Onto, Archery
捨	しゃ	す.てる	Discard, Throw Away, Abandon, Resign, Reject, Sacrifice
尺	しゃく		Shaku, Japanese Foot, Measure, Scale, Rule
若	じゃく, にゃく, にゃ	わか.い, わか-, も.しくわ, も.し, も.しくは, ごと.し	Young, If, Perhaps, Possibly, Low Number, Immature
樹	じゅ	き	Timber, Trees, Wood, Establish, Set Up
収	しゅう	おさ.める, おさ.まる	Income, Obtain, Reap, Pay, Supply, Store
宗	しゅう, そう	むね	Religion, Sect, Denomination, Main Point, Origin, Essence
就	しゅう, じゅ	つ.く, つ.ける	Concerning, Settle, Take Position, Depart, Study, Per
衆	しゅう, しゅ	おお.い	Masses, Great Numbers, Multitude, Populace
従	じゅう, しょう, じゅ	したが.う, したが.える, より	Accompany, Obey, Submit To, Comply, Follow, Secondary, Incidental, Subordinate
縦	じゅう	たて	Vertical, Length, Height, Self-indulgent, Wayward
縮	しゅく	ちぢ.む, ちぢ.まる, ちぢ.める, ちぢ.れる, ちぢ.らす	Shrink, Contract, Shrivel, Wrinkle, Reduce
熟	じゅく	う.れる	Mellow, Ripen, Mature, Acquire Skill
純	じゅん		Genuine, Purity, Innocence, Net (profit)
処	しょ	ところ, -こ, お.る	Dispose, Manage, Deal With, Sentence, Condemn, Act, Behave, Place
署	しょ		Signature, Govt Office, Police Station
諸	しょ	もろ	Various, Many, Several, Together
除	じょ, じ	のぞ.く, -よ.け	Exclude, Division (x/3), Remove, Abolish, Cancel, Except
将	しょう, そう	まさ.に, はた, まさ, ひきい.る, もって	Leader, Commander, General, Admiral, Or, And Again, Soon, From Now On, Just About
傷	しょう	きず, いた.む, いた.める	Wound, Hurt, Injure, Impair, Pain, Injury, Cut, Gash, Scar, Weak Point
障	しょう	さわ.る	Hinder, Hurt, Harm
城	じょう, せい	しろ	Castle
蒸	じょう, せい	む.す, む.れる, む.らす	Steam, Heat, Sultry, Foment, Get Musty
針	しん	はり	Needle, Pin, Staple, Stinger
仁	じん, に, にん		Humanity, Virtue, Benevolence, Charity, Man, Kernel
垂	すい	た.れる, た.らす, た.れ, -た.れ, なんなんと.す	Droop, Suspend, Hang, Slouch
推	すい	お.す	Conjecture, Infer, Guess, Suppose, Support, Push (for)
寸	すん		Measurement, Tenth Of A Shaku, A Little, Small
盛	せい, じょう	も.る, さか.る, さか.ん	Boom, Prosper, Copulate
聖	せい, しょう	ひじり	Holy, Saint, Sage, Master, Priest
誠	せい	まこと	Sincerity, Admonish, Warn, Prohibit, Truth, Fidelity
宣	せん	のたま.う	Proclaim, Say, Announce
専	せん	もっぱ.ら	Specialty, Exclusive, Mainly, Solely
泉	せん	いずみ	Spring, Fountain
洗	せん	あら.う	Wash, Inquire Into, Probe
染	せん	そ.める, -ぞ.め, -ぞめ, そ.まる, し.みる, -じ.みる, し.み, -し.める	Dye, Color, Paint, Stain, Print
善	ぜん	よ.い, い.い, よ.く, よし.とする	Virtuous, Good, Goodness
奏	そう	かな.でる	Play Music, Speak To A Ruler, Complete
窓	そう, す	まど, てんまど, けむだし	Window, Pane
創	そう, しょう	つく.る, はじ.める, きず, けず.しける	Genesis, Wound, Injury, Hurt, Start, Originate
装	そう, しょう	よそお.う, よそお.い	Attire, Dress, Pretend, Disguise, Profess
層	そう		Stratum, Social Class, Layer, Story, Floor
操	そう, さん	みさお, あやつ.る	Maneuver, Manipulate, Operate, Steer, Chastity, Virginity, Fidelity
蔵	ぞう, そう	くら, おさ.める, かく.れる	Storehouse, Hide, Own, Have, Possess
臓	ぞう	はらわた	Entrails, Viscera, Bowels
存	そん, ぞん	ながら.える, あ.る, たも.つ, と.う	Exist, Suppose, Be Aware Of, Believe, Feel
尊	そん	たっと.い, とうと.い, たっと.ぶ, とうと.ぶ	Revered, Valuable, Precious, Noble, Exalted
宅	たく		Home, House, Residence, Our House, My Husband
担	たん	かつ.ぐ, にな.う	Shouldering, Carry, Raise, Bear
探	たん	さぐ.る, さが.す	Grope, Search, Look For
誕	たん		Nativity, Be Born, Declension, Lie, Be Arbitrary
段	だん, たん		Grade, Steps, Stairs
暖	だん, のん	あたた.か, あたた.かい, あたた.まる, あたた.める	Warmth
値	ち	ね, あたい	Price, Cost, Value
宙	ちゅう		Mid-air, Air, Space, Sky, Memorization, Interval Of Time
忠	ちゅう		Loyalty, Fidelity, Faithfulness
著	ちょ, ちゃく	あらわ.す, いちじる.しい	Renowned, Publish, Write, Remarkable, Phenomenal, Put On, Don, Wear, Arrival, Finish (race), Counter For Suits Of Clothing, Literary Work
庁	ちょう, てい	やくしょ	Government Office
頂	ちょう	いただ.く, いただき	Place On The Head, Receive, Top Of Head, Top, Summit, Peak
潮	ちょう	しお, うしお	Tide, Salt Water, Opportunity
賃	ちん		Fare, Fee, Hire, Rent, Wages, Charge
痛	つう	いた.い, いた.む, いた.ましい, いた.める	Pain, Hurt, Damage, Bruise
展	てん		Unfold, Expand
討	とう	う.つ	Chastise, Attack, Defeat, Destroy, Conquer
党	とう	なかま, むら	Party, Faction, Clique
糖	とう		Sugar
届	かい	とど.ける, -とど.け, とど.く	Deliver, Reach, Arrive, Report, Notify, Forward
難	なん	かた.い, -がた.い, むずか.しい, むづか.しい, むつか.しい, -にく.い	Difficult, Impossible, Trouble, Accident, Defect
乳	にゅう	ちち, ち	Milk, Breasts
認	にん	みと.める, したた.める	Acknowledge, Witness, Discern, Recognize, Appreciate, Believe
納	のう, なっ, な, なん, とう	おさ.める, -おさ.める, おさ.まる	Settlement, Obtain, Reap, Pay, Supply, Store
脳	のう, どう	のうずる	Brain, Memory
派	は		Faction, Group, Party, Clique, Sect, School
拝	はい	おが.む, おろが.む	Worship, Adore, Pray To
背	はい	せ, せい, そむ.く, そむ.ける	Stature, Height, Back, Behind, Disobey, Defy, Go Back On, Rebel
肺	はい		Lungs
俳	はい		Haiku, Actor
班	はん		Squad, Corps, Unit, Group
晩	ばん		Nightfall, Night
否	ひ	いな, いや	Negate, No, Noes, Refuse, Decline, Deny
批	ひ		Criticism, Strike
秘	ひ	ひ.める, ひそ.か, かく.す	Secret, Conceal
腹	ふく	はら	Abdomen, Belly, Stomach
奮	ふん	ふる.う	Stirred Up, Be Invigorated, Flourish
並	へい, ほう	な.み, なみ, なら.べる, なら.ぶ, なら.びに	Row, And, Besides, As Well As, Line Up, Rank With, Rival, Equal
陛	へい		Highness, Steps (of Throne)
閉	へい	と.じる, と.ざす, し.める, し.まる, た.てる	Closed, Shut
片	へん	かた-, かた	One-sided, Leaf, Sheet, Right-side Kata Radical (no. 91)
補	ほ	おぎな.う	Supplement, Supply, Make Good, Offset, Compensate, Assistant, Learner
暮	ぼ	く.れる, く.らす	Evening, Twilight, Season's End, Livelihood, Make A Living, Spend Time
宝	ほう	たから	Treasure, Wealth, Valuables
訪	ほう	おとず.れる, たず.ねる, と.う	Call On, Visit, Look Up, Offer Sympathy
亡	ぼう, もう	な.い, な.き-, ほろ.びる, ほろ.ぶ, ほろ.ぼす	Deceased, The Late, Dying, Perish
忘	ぼう	わす.れる	Forget
棒	ぼう		Rod, Stick, Cane, Pole, Club, Line
枚	まい, ばい		Sheet Of..., Counter For Flat Thin Objects Or Sheets
幕	まく, ばく	とばり	Curtain, Bunting, Act Of Play
密	みつ	ひそ.か	Secrecy, Density (pop), Minuteness, Carefulness
盟	めい		Alliance, Oath
模	も, ぼ		Imitation, Copy, Mock
訳	やく	わけ	Translate, Reason, Circumstance, Case
郵	ゆう		Mail, Stagecoach Stop
優	ゆう, う	やさ.しい, すぐ.れる, まさ.る	Tenderness, Excel, Surpass, Actor, Superiority, Gentleness
幼	よう	おさな.い	Infancy, Childhood
欲	よく	ほっ.する, ほ.しい	Longing, Covetousness, Greed, Passion, Desire, Craving
翌	よく		The Following, Next
乱	らん, ろん	みだ.れる, みだ.る, みだ.す, みだ, おさ.める, わた.る	Riot, War, Disorder, Disturb
卵	らん	たまご	Egg, Ovum, Spawn, Roe
覧	らん	み.る	Perusal, See
裏	り	うら	Back, Amidst, In, Reverse, Inside, Palm, Sole, Rear, Lining, Wrong Side
律	りつ, りち, れつ		Rhythm, Law, Regulation, Gauge, Control
臨	りん	のぞ.む	Look To, Face, Meet, Confront, Attend, Call On
朗	ろう	ほが.らか, あき.らか	Melodious, Clear, Bright, Serene, Cheerful
論	ろん		Argument, Discourse
