悪	あく, お	わる.い, わる-, あ.し, にく.い, -にく.い, ああ, いずくに, いずくんぞ, にく.む	Bad, Vice, Rascal, False, Evil, Wrong
安	あん	やす.い, やす.まる, やす, やす.らか	Relax, Cheap, Low, Quiet, Rested, Contented, Peaceful
暗	あん	くら.い, くら.む, くれ.る	Darkness, Disappear, Shade, Informal, Grow Dark, Be Blinded
医	い	い.やす, い.する, くすし	Doctor, Medicine
委	い	ゆだ.ねる	Committee, Entrust To, Leave To, Devote, Discard
意	い		Idea, Mind, Heart, Taste, Thought, Desire, Care, Liking
育	いく	そだ.つ, そだ.ち, そだ.てる, はぐく.む	Bring Up, Grow Up, Raise, Rear
員	いん		Employee, Member, Number, The One In Charge
院	いん		Inst., Institution, Temple, Mansion, School
飲	いん, おん	の.む, -の.み	Drink, Smoke, Take
運	うん	はこ.ぶ	Carry, Luck, Destiny, Fate, Lot, Transport, Progress, Advance
泳	えい	およ.ぐ	Swim
駅	えき		Station
央	おう		Center, Middle
横	おう	よこ	Sideways, Side, Horizontal, Width, Woof, Unreasonable, Perverse
屋	おく	や	Roof, House, Shop, Dealer, Seller
温	おん	あたた.か, あたた.かい, あたた.まる, あたた.める, ぬく	Warm
化	か, け	ば.ける, ば.かす, ふ.ける, け.する	Change, Take The Form Of, Influence, Enchant, Delude, -ization
荷	か	に	Baggage, Shoulder-pole Load, Bear (a Burden), Shoulder (a Gun), Load, Cargo, Freight
界	かい		World, Boundary
開	かい	ひら.く, ひら.き, -びら.き, ひら.ける, あ.く, あ.ける	Open, Unfold, Unseal
階	かい	きざはし	Storey, Stair, Counter For Storeys Of A Building
寒	かん	さむ.い	Cold
感	かん		Emotion, Feeling, Sensation
漢	かん		Sino-, China
館	かん	やかた, たて	Building, Mansion, Large Building, Palace
岸	がん	きし	Beach
起	き	お.きる, お.こる, お.こす, おこ.す, た.つ	Rouse, Wake Up, Get Up
期	き, ご		Period, Time, Date, Term
客	きゃく, かく		Guest, Visitor, Customer, Client
究	きゅう, く	きわ.める	Research, Study
急	きゅう	いそ.ぐ, いそ.ぎ, せ.く	Hurry, Emergency, Sudden, Steep
級	きゅう		Class, Rank, Grade
宮	きゅう, ぐう, く, くう	みや	Shinto Shrine, Constellations, Palace, Princess
球	きゅう	たま	Ball, Sphere
去	きょ, こ	さ.る, -さ.る	Gone, Past, Quit, Leave, Elapse, Eliminate, Divorce
橋	きょう	はし	Bridge
業	ぎょう, ごう	わざ	Business, Vocation, Arts, Performance
曲	きょく	ま.がる, ま.げる, くま	Bend, Music, Melody, Composition, Pleasure, Injustice, Fault, Curve, Crooked, Perverse, Lean
局	きょく	つぼね	Bureau, Board, Office, Affair, Conclusion, Court Lady, Lady-in-waiting, Her Apartment
銀	ぎん	しろがね	Silver
区	く, おう, こう		Ward, District
苦	く	くる.しい, -ぐる.しい, くる.しむ, くる.しめる, にが.い, にが.る	Suffering, Trial, Worry, Hardship, Feel Bitter, Scowl
具	ぐ	そな.える, つぶさ.に	Tool, Utensil, Means, Possess, Ingredients, Counter For Armor, Suits, Sets Of Furniture
君	くん	きみ, -ぎみ	Mister, You, Ruler, Male Name Suffix
係	けい	かか.る, かかり, -がかり, かか.わる	Person In Charge, Connection, Duty, Concern Oneself
軽	けい, きょう, きん	かる.い, かろ.やか, かろ.んじる	Lightly, Trifling, Unimportant
血	けつ	ち	Blood
決	けつ	き.める, -ぎ.め, き.まる, さ.く	Decide, Fix, Agree Upon, Appoint
研	けん	と.ぐ	Polish, Study Of, Sharpen
県	けん	か.ける	Prefecture
庫	こ, く	くら	Warehouse, Storehouse
湖	こ	みずうみ	Lake
向	こう	む.く, む.い, -む.き, む.ける, -む.け, む.かう, む.かい, む.こう, む.こう-, むこ, むか.い	Yonder, Facing, Beyond, Confront, Defy, Tend Toward, Approach
幸	こう	さいわ.い, さち, しあわ.せ	Happiness, Blessing, Fortune
港	こう	みなと	Harbor
号	ごう	さけ.ぶ, よびな	Nickname, Number, Item, Title, Pseudonym, Name, Call
根	こん	ね, -ね	Root, Radical, Head (pimple)
祭	さい	まつ.る, まつ.り, まつり	Ritual, Offer Prayers, Celebrate, Deify, Enshrine, Worship
皿	べい	さら	Dish, A Helping, Plate
仕	し, じ	つか.える	Attend, Doing, Official, Serve
死	し	し.ぬ, し.に-	Death, Die
使	し	つか.う, つか.い, -つか.い, -づか.い	Use, Send On A Mission, Order, Messenger, Envoy, Ambassador, Cause
始	し	はじ.める, -はじ.める, はじ.まる	Commence, Begin
指	し	ゆび, さ.す, -さ.し	Finger, Point To, Indicate, Put Into, Play (chess), Measure (ruler)
歯	し	よわい, は, よわ.い, よわい.する	Tooth, Cog
詩	し	うた	Poem, Poetry
次	じ, し	つ.ぐ, つぎ	Next, Order, Sequence
事	じ, ず	こと, つか.う, つか.える	Matter, Thing, Fact, Business, Reason, Possibly
持	じ	も.つ, -も.ち, も.てる	Hold, Have
式	しき		Style, Ceremony, Rite, Function, Method, System, Form, Expression
実	じつ, しつ	み, みの.る, まこと, みの, みち.る	Reality, Truth
写	しゃ, じゃ	うつ.す, うつ.る, うつ-, うつ.し	Copy, Be Photographed, Describe
者	しゃ	もの	Someone, Person
主	しゅ, す, しゅう	ぬし, おも, あるじ	Lord, Chief, Master, Main Thing, Principal
守	しゅ, す	まも.る, まも.り, もり, -もり, かみ	Guard, Protect, Defend, Obey
取	しゅ	と.る, と.り, と.り-, とり, -ど.り	Take, Fetch, Take Up
酒	しゅ	さけ, さか-	Sake, Alcohol
受	じゅ	う.ける, -う.け, う.かる	Accept, Undergo, Answer (phone), Take, Get, Catch, Receive
州	しゅう, す	す	State, Province
拾	しゅう, じゅう	ひろ.う	Pick Up, Gather, Find, Go On Foot, Ten
終	しゅう	お.わる, -お.わる, おわ.る, お.える, つい, つい.に	End, Finish
習	しゅう, じゅ	なら.う, なら.い	Learn
集	しゅう	あつ.まる, あつ.める, つど.う	Gather, Meet, Congregate, Swarm, Flock
住	じゅう, ぢゅう, ちゅう	す.む, す.まう, -ず.まい	Dwell, Reside, Live, Inhabit
重	じゅう, ちょう	え, おも.い, おも.り, おも.なう, かさ.ねる, かさ.なる, おも	Heavy, Important, Esteem, Respect, Heap Up, Pile Up, Nest Of Boxes, -fold
宿	しゅく	やど, やど.る, やど.す	Inn, Lodging, Relay Station, Dwell, Lodge, Be Pregnant, Home, Dwelling
所	しょ	ところ, -ところ, どころ, とこ	Place, Extent
暑	しょ	あつ.い	Sultry, Hot, Summer Heat
助	じょ	たす.ける, たす.かる, す.ける, すけ	Help, Rescue, Assist
昭	しょう		Shining, Bright
消	しょう	き.える, け.す	Extinguish, Blow Out, Turn Off, Neutralize, Cancel
商	しょう	あきな.う	Make A Deal, Selling, Dealing In, Merchant
章	しょう		Badge, Chapter, Composition, Poem, Design
勝	しょう	か.つ, -が.ち, まさ.る, すぐ.れる, かつ	Victory, Win, Prevail, Excel
乗	じょう, しょう	の.る, -の.り, の.せる	Ride, Power, Multiplication, Record, Counter For Vehicles, Board, Mount, Join
植	しょく	う.える, う.わる	Plant
申	しん	もう.す, もう.し-, さる	Have The Honor To, Sign Of The Monkey, 3-5pm, Ninth Sign Of Chinese Zodiac
身	しん	み	Somebody, Person, One's Station In Life
神	しん, じん	かみ, かん-, こう-	Gods, Mind, Soul
真	しん	ま, ま-, まこと	True, Reality, Buddhist Sect
深	しん	ふか.い, -ぶか.い, ふか.まる, ふか.める, み-	Deep, Heighten, Intensify, Strengthen
進	しん	すす.む, すす.める	Advance, Proceed, Progress, Promote
世	せい, せ, そう	よ	Generation, World, Society, Public
整	せい	ととの.える, ととの.う	Organize, Arranging, Tune, Tone, Meter, Key (music)
昔	せき, しゃく	むかし	Once Upon A Time, Antiquity, Old Times
全	ぜん	まった.く, すべ.て	Whole, Entire, All, Complete, Fulfill
相	そう, しょう	あい-	Inter-, Mutual, Together, Each Other, Minister Of State, Councillor, Aspect, Phase, Physiognomy
送	そう	おく.る	Escort, Send
想	そう, そ	おも.う	Concept, Think, Idea, Thought
息	そく	いき	Breath, Respiration, Son, Interest (on Money)
速	そく	はや.い, はや-, はや.める, すみ.やか	Quick, Fast
族	ぞく		Tribe, Family
他	た	ほか	Other, Another, The Others
打	だ, だあす	う.つ, う.ち-, ぶ.つ	Strike, Hit, Knock, Pound, Dozen
対	たい, つい	あいて, こた.える, そろ.い, つれあ.い, なら.ぶ, むか.う	Vis-a-vis, Opposite, Even, Equal, Versus, Anti-, Compare
待	たい	ま.つ, -ま.ち	Wait, Depend On
代	だい, たい	か.わる, かわ.る, かわ.り, か.わり, -がわ.り, -が.わり, か.える, よ, しろ	Substitute, Change, Convert, Replace, Period, Age, Counter For Decades Of Ages, Eras, Etc., Generation, Charge, Rate, Fee
第	だい, てい		No., Residence
題	だい		Topic, Subject
炭	たん	すみ	Charcoal, Coal
短	たん	みじか.い	Short, Brevity, Fault, Defect, Weak Point
談	だん		Discuss, Talk
着	ちゃく, じゃく	き.る, -ぎ, き.せる, -き.せ, つ.く, つ.ける	Don, Arrive, Wear, Counter For Suits Of Clothing
注	ちゅう	そそ.ぐ, さ.す, つ.ぐ	Pour, Irrigate, Shed (tears), Flow Into, Concentrate On, Notes, Comment, Annotate
柱	ちゅう	はしら	Pillar, Post, Cylinder, Support
丁	ちょう, てい, ちん, とう, ち	ひのと	Street, Ward, Town, Counter For Guns, Tools, Leaves Or Cakes Of Something, Even Number, 4th Calendar Sign
帳	ちょう	とばり	Notebook, Account Book, Album, Curtain, Veil, Net, Tent
調	ちょう	しら.べる, しら.べ, ととの.う, ととの.える	Tune, Tone, Meter, Key (music), Writing Style, Prepare, Exorcise, Investigate, Harmonize, Mediate
追	つい	お.う	Chase, Drive Away, Follow, Pursue, Meanwhile
定	てい, じょう	さだ.める, さだ.まる, さだ.か	Determine, Fix, Establish, Decide
庭	てい	にわ	Courtyard, Garden, Yard
笛	てき	ふえ	Flute, Clarinet, Pipe, Whistle, Bagpipe, Piccolo
鉄	てつ	くろがね	Iron
転	てん	ころ.がる, ころ.げる, ころ.がす, ころ.ぶ, まろ.ぶ, うたた, うつ.る, くる.めく	Revolve, Turn Around, Change
都	と, つ	みやこ	Metropolis, Capital, All, Everything
度	ど, と, たく	たび, -た.い	Degrees, Occurrence, Time, Counter For Occurrences, Consider, Attitude
投	とう	な.げる, -な.げ	Throw, Discard, Abandon, Launch Into, Join, Invest In, Hurl, Give Up, Sell At A Loss
豆	とう, ず	まめ, まめ-	Beans, Pea, Midget
島	とう	しま	Island
湯	とう	ゆ	Hot Water, Bath, Hot Spring
登	とう, と, どう, しょう, ちょう	のぼ.る, あ.がる	Ascend, Climb Up
等	とう	ひと.しい, など, -ら	Etc., And So Forth, Class (first), Quality, Equal, Similar
動	どう	うご.く, うご.かす	Move, Motion, Change, Confusion, Shift, Shake
童	どう	わらべ	Juvenile, Child
農	のう		Agriculture, Farmers
波	は	なみ	Waves, Billows, Poland
配	はい	くば.る	Distribute, Spouse, Exile, Rationing
倍	ばい		Double, Twice, Times, Fold
箱	そう	はこ	Box, Chest, Case, Bin, Railway Car
畑		はた, はたけ, -ばたけ	Farm, Field, Garden, One's Specialty, (kokuji)
発	はつ, ほつ	た.つ, あば.く, おこ.る, つか.わす, はな.つ	Departure, Discharge, Publish, Emit, Start From, Disclose, Counter For Gunshots
反	はん, ほん, たん, ほ	そ.る, そ.らす, かえ.す, かえ.る, -かえ.る	Anti-
坂	はん	さか	Slope, Incline, Hill
板	はん, ばん	いた	Plank, Board, Plate, Stage
皮	ひ	かわ	Pelt, Skin, Hide, Leather, Skin Radical (no. 107)
悲	ひ	かな.しい, かな.しむ	Grieve, Sad, Deplore, Regret
美	び, み	うつく.しい	Beauty, Beautiful
鼻	び	はな	Nose, Snout
筆	ひつ	ふで	Writing Brush, Writing, Painting Brush, Handwriting
氷	ひょう	こおり, ひ, こお.る	Icicle, Ice, Hail, Freeze, Congeal
表	ひょう	おもて, -おもて, あらわ.す, あらわ.れる, あら.わす	Surface, Table, Chart, Diagram
秒	びょう		Second (1/60 Minute)
病	びょう, へい	や.む, -や.み, やまい	Ill, Sick
品	ひん, ほん	しな	Goods, Refinement, Dignity, Article, Counter For Meal Courses
負	ふ	ま.ける, ま.かす, お.う	Defeat, Negative, -, Minus, Bear, Owe, Assume A Responsibility
部	ぶ	-べ	Section, Bureau, Dept, Class, Copy, Part, Portion, Counter For Copies Of A Newspaper Or Magazine
服	ふく		Clothing, Admit, Obey, Discharge
福	ふく		Blessing, Fortune, Luck, Wealth
物	ぶつ, もつ	もの, もの-	Thing, Object, Matter
平	へい, びょう, ひょう	たい.ら, -だいら, ひら, ひら-	Even, Flat, Peace
返	へん	かえ.す, -かえ.す, かえ.る, -かえ.る	Return, Answer, Fade, Repay
勉	べん	つと.める	Exertion, Endeavour, Encourage, Strive, Make Effort, Diligent
放	ほう	はな.す, -っぱな.し, はな.つ, はな.れる, こ.く, ほう.る	Set Free, Release, Fire, Shoot, Emit, Banish, Liberate
味	み	あじ, あじ.わう	Flavor, Taste
命	めい, みょう	いのち	Fate, Command, Decree, Destiny, Life, Appoint
面	めん, べん	おも, おもて, つら	Mask, Face, Features, Surface
問	もん	と.う, と.い, とん	Question, Ask, Problem
役	やく, えき		Duty, War, Campaign, Drafted Labor, Office, Service, Role
薬	やく	くすり	Medicine, Chemical, Enamel, Gunpowder, Benefit
由	ゆ, ゆう, ゆい	よし, よ.る	Wherefore, A Reason
油	ゆ, ゆう	あぶら	Oil, Fat
有	ゆう, う	あ.る	Possess, Have, Exist, Happen, Occur, Approx
遊	ゆう, ゆ	あそ.ぶ, あそ.ばす	Play
予	よ, しゃ	あらかじ.め	Beforehand, Previous, Myself, I
羊	よう	ひつじ	Sheep
洋	よう		Ocean, Sea, Foreign, Western Style
葉	よう	は	Leaf, Plane, Lobe, Needle, Blade, Spear, Counter For Flat Things, Fragment, Piece
陽	よう	ひ	Sunshine, Yang Principle, Positive, Male, Heaven, Daytime
様	よう, しょう	さま, さん	Esq., Way, Manner, Situation, Polite Suffix
落	らく	お.ちる, お.ち, お.とす	Fall, Drop, Come Down, Village, Hamlet
流	りゅう, る	なが.れる, なが.れ, なが.す, -なが.す	Current, A Sink, Flow, Forfeit
旅	りょ	たび	Trip, Travel
両	りょう	てる, ふたつ	Both, Old Japanese Coin, Counter For Carriages (e.g., In A Train), Two
緑	りょく, ろく	みどり	Green
礼	れい, らい		Salute, Bow, Ceremony, Thanks, Remuneration
列	れつ, れ		File, Row, Rank, Tier, Column
練	れん	ね.る, ね.り	Practice, Gloss, Train, Drill, Polish, Refine
路	ろ, る	-じ, みち	Path, Route, Road, Distance
和	わ, お, か	やわ.らぐ, やわ.らげる, なご.む, なご.やか, あ.える	Harmony, Japanese Style, Peace, Soften, Japan
