圧	あつ, えん, おう	お.す, へ.す, おさ.える, お.さえる	Pressure, Push, Overwhelm, Oppress, Dominate
移	い	うつ.る, うつ.す	Shift, Move, Change, Drift, Catch (cold, Fire), Pass Into
因	いん	よ.る, ちな.む	Cause, Factor, Be Associated With, Depend On, Be Limited To
永	えい	なが.い	Eternity, Long, Lengthy
営	えい	いとな.む, いとな.み	Occupation, Camp, Perform, Build, Conduct (business)
衛	えい, え		Defense, Protection
易	えき, い	やさ.しい, やす.い	Easy, Ready To, Simple, Fortune-telling, Divination
益	えき, やく	ま.す	Benefit, Gain, Profit, Advantage
液	えき		Fluid, Liquid, Juice, Sap, Secretion
演	えん		Performance, Act, Play, Render, Stage
応	おう, よう, -のう	あた.る, まさに, こた.える	Apply, Answer, Yes, Ok, Reply, Accept
往	おう	い.く, いにしえ, さき.に, ゆ.く	Journey, Travel, Chase Away, Let Go, Going, Before, Formerly
桜	おう, よう	さくら	Cherry
恩	おん		Grace, Kindness, Goodness, Favor, Mercy, Blessing, Benefit
可	か, こく	-べ.き, -べ.し	Can, Passable, Mustn't, Should Not, Do Not
仮	か, け	かり, かり-	Sham, Temporary, Interim, Assumed (name), Informal
価	か, け	あたい	Value, Price
河	か	かわ	River
過	か	す.ぎる, -す.ぎる, -す.ぎ, す.ごす, あやま.つ, あやま.ち, よ.ぎる	Overdo, Exceed, Go Beyond, Error
賀	が		Congratulations, Joy
快	かい	こころよ.い	Cheerful, Pleasant, Agreeable, Comfortable
解	かい, げ	と.く, と.かす, と.ける, ほど.く, ほど.ける, わか.る, さと.る	Unravel, Notes, Key, Explanation, Understanding, Untie, Undo, Solve, Answer, Cancel, Absolve, Explain, Minute
格	かく, こう, きゃく, ごう		Status, Rank, Capacity, Character, Case (law, Grammar)
確	かく, こう	たし.か, たし.かめる	Assurance, Firm, Tight, Hard, Solid, Confirm, Clear, Evident
額	がく	ひたい	Forehead, Tablet, Plaque, Framed Picture, Sum, Amount, Volume
刊	かん		Publish, Carve, Engrave
幹	かん	みき	Tree Trunk, Main Part, Talent, Capability
慣	かん	な.れる, な.らす	Accustomed, Get Used To, Become Experienced
眼	がん, げん	まなこ, め	Eyeball
基	き	もと, もとい	Fundamentals, Radical (chem), Counter For Machines, Foundation
寄	き	よ.る, -よ.り, よ.せる	Draw Near, Stop In, Bring Near, Gather, Collect, Send, Forward
規	き		Standard, Measure
技	ぎ	わざ	Skill, Art, Craft, Ability, Feat, Performance, Vocation, Arts
義	ぎ		Righteousness, Justice, Morality, Honor, Loyalty, Meaning
逆	ぎゃく, げき	さか, さか.さ, さか.らう	Inverted, Reverse, Opposite, Wicked
久	きゅう, く	ひさ.しい	Long Time, Old Story
旧	きゅう	ふる.い, もと	Old Times, Old Things, Old Friend, Former, Ex-
居	きょ, こ	い.る, -い, お.る	Reside, To Be, Exist, Live With
許	きょ	ゆる.す, もと	Permit, Approve
境	きょう, けい	さかい	Boundary, Border, Region
均	きん	なら.す	Level, Average
禁	きん		Prohibition, Ban, Forbid
句	く		Phrase, Clause, Sentence, Passage, Paragraph, Counter For Haiku
群	ぐん	む.れる, む.れ, むら, むら.がる	Flock, Group, Crowd, Herd, Swarm, Cluster
経	けい, きょう, きん	へ.る, た.つ, たていと, はか.る, のり	Sutra, Longitude, Pass Thru, Expire, Warp
潔	けつ	いさぎよ.い	Undefiled, Pure, Clean, Righteous, Gallant
件	けん	くだん	Affair, Case, Matter, Item
券	けん		Ticket
険	けん	けわ.しい	Precipitous, Inaccessible Place, Impregnable Position, Steep Place, Sharp Eyes
検	けん	しら.べる	Examination, Investigate
限	げん	かぎ.る, かぎ.り, -かぎ.り	Limit, Restrict, To Best Of Ability
現	げん	あらわ.れる, あらわ.す, うつつ, うつ.つ	Present, Existing, Actual
減	げん	へ.る, へ.らす	Dwindle, Decrease, Reduce, Decline, Curtail, Get Hungry
故	こ	ゆえ, ふる.い, もと	Happenstance, Especially, Intentionally, Reason, Cause, Circumstances, The Late, Therefore, Consequently
個	こ, か		Individual, Counter For Articles
護	ご	まも.る	Safeguard, Protect
効	こう	き.く, ききめ, なら.う	Merit, Efficacy, Efficiency, Benefit
厚	こう	あつ.い, あか	Thick, Heavy, Rich, Kind, Cordial, Brazen, Shameless
耕	こう	たがや.す	Till, Plow, Cultivate
鉱	こう	あらがね	Mineral, Ore
構	こう	かま.える, かま.う	Posture, Build, Pretend
興	こう, きょう	おこ.る, おこ.す	Entertain, Revive, Retrieve, Interest, Pleasure
講	こう		Lecture, Club, Association
混	こん	ま.じる, -ま.じり, ま.ざる, ま.ぜる, こ.む	Mix, Blend, Confuse
査	さ		Investigate
再	さい, さ	ふたた.び	Again, Twice, Second Time
災	さい	わざわ.い	Disaster, Calamity, Woe, Curse, Evil
妻	さい	つま	Wife, Spouse
採	さい	と.る	Pick, Take, Fetch, Take Up
際	さい	きわ, -ぎわ	Occasion, Side, Edge, Verge, Dangerous, Adventurous, Indecent, Time, When
在	ざい	あ.る	Exist, Outskirts, Suburbs, Located In
財	ざい, さい, ぞく	たから	Property, Money, Wealth, Assets
罪	ざい	つみ	Guilt, Sin, Crime, Fault, Blame, Offense
雑	ざつ, ぞう	まじ.える, まじ.る	Miscellaneous
酸	さん	す.い	Acid, Bitterness, Sour, Tart
賛	さん	たす.ける, たた.える	Approve, Praise, Title Or Inscription On Picture, Assist, Agree With
支	し	ささ.える, つか.える, か.う	Branch, Support, Sustain, Branch Radical (no. 65)
志	し	シリング, こころざ.す, こころざし	Intention, Plan, Resolve, Aspire, Motive, Hopes, Shilling
枝	し	えだ	Bough, Branch, Twig, Limb, Counter For Branches
師	し	いくさ	Expert, Teacher, Master, Model, Exemplar, Army (incl. Counter), War
資	し		Assets, Resources, Capital, Funds, Data, Be Conducive To, Contribute To
飼	し	か.う	Domesticate, Raise, Keep, Feed
示	じ, し	しめ.す	Show, Indicate, Point Out, Express, Display
似	じ	に.る, ひ.る	Becoming, Resemble, Counterfeit, Imitate, Suitable
識	しき	し.る, しる.す	Discriminating, Know, Write
質	しつ, しち, ち	たち, ただ.す, もと, わりふ	Substance, Quality, Matter, Temperament
舎	しゃ, せき	やど.る	Cottage, Inn, Hut, House, Mansion
謝	しゃ	あやま.る	Apologize, Thank, Refuse
授	じゅ	さず.ける, さず.かる	Impart, Instruct, Grant, Confer
修	しゅう, しゅ	おさ.める, おさ.まる	Discipline, Conduct Oneself Well, Study, Master
述	じゅつ	の.べる	Mention, State, Speak, Relate
術	じゅつ	すべ	Art, Technique, Skill, Means, Trick, Resources, Magic
準	じゅん	じゅん.じる, じゅん.ずる, なぞら.える, のり, ひと.しい, みずもり	Semi-, Correspond To, Proportionate To, Conform, Imitate
序	じょ	つい.で, ついで	Preface, Beginning, Order, Precedence, Occasion, Chance, Incidentally
招	しょう	まね.く	Beckon, Invite, Summon, Engage
承	しょう, じょう	うけたまわ.る, う.ける	Acquiesce, Hear, Listen To, Be Informed, Receive
証	しょう	あかし	Evidence, Proof, Certificate
条	じょう, ちょう, でき	えだ, すじ	Article, Clause, Item, Stripe, Streak
状	じょう		Status Quo, Conditions, Circumstances, Form, Appearance
常	じょう	つね, とこ-	Usual, Ordinary, Normal, Common, Regular, Continually, Always, Long-lasting
情	じょう, せい	なさ.け	Feelings, Emotion, Passion, Sympathy, Circumstances, Facts
織	しょく, しき	お.る, お.り, おり, -おり, -お.り	Weave, Fabric
職	しょく, そく		Post, Employment, Work
制	せい		System, Law, Rule
性	せい, しょう	さが	Sex, Gender, Nature
政	せい, しょう	まつりごと, まん	Politics, Government
勢	せい, ぜい	いきお.い, はずみ	Forces, Energy, Military Strength
精	せい, しょう	しら.げる, くわ.しい	Refined, Ghost, Fairy, Energy, Vitality, Semen, Excellence, Purity, Skill
製	せい		Made In..., Manufacture
税	ぜい		Tax, Duty
責	せき	せ.める	Blame, Condemn, Censure
績	せき		Exploits, Achievements, Unreeling Cocoons
接	せつ, しょう	つ.ぐ	Touch, Contact, Adjoin, Piece Together
設	せつ	もう.ける	Establishment, Provision, Prepare
舌	ぜつ	した	Tongue, Reed, Clapper
絶	ぜつ	た.える, た.やす, た.つ	Discontinue, Sever, Cut Off, Abstain, Interrupt, Suppress, Be Beyond, Without Match, Peerless, Unparalleled
銭	せん, ぜん	ぜに, すき	Coin, .01 Yen, Money
祖	そ		Ancestor, Pioneer, Founder
素	そ, す	もと	Elementary, Principle, Naked, Uncovered
総	そう	す.べて, すべ.て, ふさ	General, Whole, All, Full, Total
造	ぞう	つく.る, つく.り, -づく.り	Create, Make, Structure, Physique
像	ぞう		Statue, Picture, Image, Figure, Portrait
増	ぞう	ま.す, ま.し, ふ.える, ふ.やす	Increase, Add, Augment, Gain, Promote
則	そく	のっと.る	Rule, Follow, Based On, Model After
測	そく	はか.る	Fathom, Plan, Scheme, Measure
属	ぞく, しょく	さかん, つく, やから	Belong, Genus, Subordinate Official, Affiliated
率	そつ, りつ, しゅつ	ひき.いる	Ratio, Rate, Proportion, %, Factor, Lead, Spearhead, Command
損	そん	そこ.なう, そこな.う, -そこ.なう, そこ.ねる, -そこ.ねる	Damage, Loss, Disadvantage, Hurt, Injure
退	たい	しりぞ.く, しりぞ.ける, ひ.く, の.く, の.ける, ど.く	Retreat, Withdraw, Retire, Resign, Repel, Expel, Reject
貸	たい	か.す, か.し-, かし-	Lend
態	たい	わざ.と	Attitude, Condition, Figure, Appearance, Voice (of Verbs)
団	だん, とん	かたまり, まる.い	Group, Association
断	だん	た.つ, ことわ.る, さだ.める	Severance, Decline, Refuse, Apologize, Warn, Dismiss, Prohibit, Decision, Judgement, Cutting
築	ちく	きず.く	Fabricate, Build, Construct
張	ちょう	は.る, -は.り, -ば.り	Lengthen, Counter For Bows & Stringed Instruments, Stretch, Spread, Put Up (tent)
提	てい, ちょう, だい	さ.げる	Propose, Take Along, Carry In Hand
程	てい	ほど, -ほど	Extent, Degree, Law, Formula, Distance, Limits, Amount
適	てき	かな.う	Suitable, Occasional, Rare, Qualified, Capable
敵	てき	かたき, あだ, かな.う	Enemy, Foe, Opponent
統	とう	す.べる, ほび.る	Overall, Relationship, Ruling, Governing
銅	どう	あかがね	Copper
導	どう	みちび.く	Guidance, Leading, Conduct, Usher
徳	とく		Benevolence, Virtue, Goodness, Commanding Respect
独	どく, とく	ひと.り	Single, Alone, Spontaneously, Germany
任	にん	まか.せる, まか.す	Responsibility, Duty, Term, Entrust To, Appoint
燃	ねん	も.える, も.やす, も.す	Burn, Blaze, Glow
能	のう	よ.く	Ability, Talent, Skill, Capacity
破	は	やぶ.る, やぶ.れる, わ.れる	Rend, Rip, Tear, Break, Destroy, Defeat, Frustrate
犯	はん, ぼん	おか.す	Crime, Sin, Offense
判	はん, ばん	わか.る	Judgement, Signature, Stamp, Seal
版	はん		Printing Block, Printing Plate, Edition, Impression, Label
比	ひ	くら.べる	Compare, Race, Ratio, Philippines
肥	ひ	こ.える, こえ, こ.やす, こ.やし, ふと.る	Fertilizer, Get Fat, Fertile, Manure, Pamper
非	ひ	あら.ず	Un-, Mistake, Negative, Injustice, Non-
備	び	そな.える, そな.わる, つぶさ.に	Equip, Provision, Preparation
俵	ひょう	たわら	Bag, Bale, Sack, Counter For Bags
評	ひょう		Evaluate, Criticism, Comment
貧	ひん, びん	まず.しい	Poverty, Poor
布	ふ	ぬの	Linen, Cloth, Spread, Distribute
婦	ふ	よめ	Lady, Woman, Wife, Bride
富	ふ, ふう	と.む, とみ	Wealth, Enrich, Abundant
武	ぶ, む	たけ, たけ.し	Warrior, Military, Chivalry, Arms
復	ふく	また	Restore, Return To, Revert, Resume
複	ふく		Duplicate, Double, Compound, Multiple
仏	ぶつ, ふつ	ほとけ	Buddha, The Dead, France
編	へん	あ.む, -あ.み	Compilation, Knit, Plait, Braid, Twist, Editing, Completed Poem, Part Of A Book
弁	べん, へん	かんむり, わきま.える, わ.ける, はなびら, あらそ.う	Valve, Petal, Braid, Speech, Dialect, Discrimination, Dispose Of, Distinguish, Conical Cap
保	ほ, ほう	たも.つ	Protect, Guarantee, Keep, Preserve, Sustain, Support
墓	ぼ	はか	Grave, Tomb
報	ほう	むく.いる	Report, News, Reward, Retribution
豊	ほう, ぶ	ゆた.か, とよ	Bountiful, Excellent, Rich
防	ぼう	ふせ.ぐ	Ward Off, Defend, Protect, Resist
貿	ぼう		Trade, Exchange
暴	ぼう, ばく	あば.く, あば.れる	Outburst, Rave, Fret, Force, Violence, Cruelty, Outrage
務	む	つと.める	Task, Duties
夢	む, ぼう	ゆめ, ゆめ.みる, くら.い	Dream, Vision, Illusion
迷	めい	まよ.う	Astray, Be Perplexed, In Doubt, Lost, Err, Illusion
綿	めん	わた	Cotton
輸	ゆ, しゅ		Transport, Send, Be Inferior
余	よ	あま.る, あま.り, あま.す, あんま.り	Too Much, Myself, Surplus, Other, Remainder
預	よ	あず.ける, あず.かる	Deposit, Custody, Leave With, Entrust To
容	よう	い.れる	Contain, Form, Looks
略	りゃく	ほぼ, はぶ.く, おか.す, おさ.める, はかりごと, はか.る	Abbreviation, Omission, Outline, Shorten, Capture, Plunder
留	りゅう, る	と.める, と.まる, とど.める, とど.まる, るうぶる	Detain, Fasten, Halt, Stop
領	りょう	えり	Jurisdiction, Dominion, Territory, Fief, Reign
